NO ./textures/ll.xpm
SO ./textures/ll.xpm
WE ./textures/ll.xpm
EA ./textures/ll.xpm

F 225,100,0
C 226,30,0



11111
10001
11111
