NO ./textures/ll.xpm
SO ./textures/ll.xpm
WE ./textures/ll.xpm
EA ./textures/ll.xpm

F 225,100,0
C 226,30,0

 1111111111111111111111111
1000000000110000000000001
1011000001110000000000001