NO ./textures/ll.xpm
SO ./textures/ll.xpm
EA ./textures/ll.xpm
WE ./textures/ll.xpm

F 220,100,3
C 211,88,12

		1111111111111111111111111
		1000000000110000000000001
		1011000001110000000000001
		1001000000000000000000001
111111111011000001110000000000001
100000000011000001110111111111111
11110111111111011100000010001
1111111111111111 111111111111111
1111011111S111011101010010001
11000000010101011100000010001
10000000 00000001100000010001
1000001000000001101010010001d
110000001101010111110111100111
11110111 1110101 101111010001
11111111 1111111 111111111111




























