	NO ./textures/ll.xpm
			SO ./textures/ll.xpm
	            WE ./textures/ll.xpm
EA ./textures/ll.xpm


F      220, 100,3    
C     2,10,20

1111111111111111111111111
1000000000110000000000001
	1011000001110000000000001
1001000000000000000000001
111111111011000001110000000000001
100000000011000001110111111111111
11110111111111011100000010001
11110111111111011101010010001
11000000110101011100000010001
1000000000N0001100000010001
1000000000000000111010010001
11000001110101011111011110N0111
11110111 1110101 101111010001 
11111111 1111111 111111111111