NO ./textures/ll.xpm
SO ./textures/ll.xpm
EA ./textures/ll.xpm
WE ./textures/ll.xpm





		C  					211, 		    88,12
				F 220,255,3





		111111111111111111111111
		1000000000110000000000001
		101100000111000000000000111
		100100000000000000000001000001
111111111011000001110000000000011111
100000000011000001110111111111111
11110111111111011100000010001
11110111111111011101010010001
1100000011010101110000100011
10000000000000001100000010001
10000000000000001101010010001
11000001110101011111011110N0111
11110111 1110101 101111010001
11111111 1111111 111111111111
















