
SO ./textures/ll.xpm
WE ./textures/ll.xpm
NO ./textures/lsl.xpm
EA ./textures/ll.xpm

C 225,30,0
F 222,100,0

111111111111111111111111
1000000000110000000000001
1011000001110000000000001
1001000000000000000000001
111111111011000001110000000000001
100000000011000001110111111111111
11110111111111011100000010001
11110111111111011101010010001
1111111111111110011111111111111111
11001010110101011100000010001
10000100000000001100000010001
10000000000000001101010010001
11000001110101011111011110N0111
11110111 11 10101 101111010001
11111111 1111111 1111101111111
11111111 1111111 111111111111
