        NO ./textures/ll.xpm
SO  				./textures/ll.xpm
EA ./textures/ll.xpm
WE 					./textures/ll.xpm




F     220,    34,                                               3       
C 111, 88,     12


                         1                        1
                        101                      101
                       10001                    10001
                      1000001                  1000001
                     100000001                100000001
                    10000000001              10000000001
                   1000000000001            1000000000001
                  100000000000001          100000000000001
                 10000000000000001        10000000000000001
                1000000000000000001      1000000000000000001
               100000000000000000001    100000000000000000001
              100000000000000000000011110000000000000000000001
              10000000000W000000000000000000000000000000000001
               1000000000000000000111111110000000000000000001
                100000000000000001        100000000000000001
                 1000000000000001          1000000000000001
         11111111100000000000001            10000000000000111111111
         1000000000000000000001              1000000000000000000001
         100011111111100000001                100000001111111110001
         10001        1000001                  1000001        10001
         10001         10001                    10001         10001
         10001          101                      101          10001
         10001           1                        1           10001
         10001                                                10001
         10001                                                10001
         1000111111111111111111111111111111111111111111111111110001
         1000000000000000000000000000000000000000000000000000000001
         1000000000000000000000000000000000000000000000000000000001
         1000000000000000000000000000000000000000000000000000000001
         1000000000000000000000000000000000000000000000000000000001
         1000000000000000000000000000000000000000000000000000000001
         1000000000000000000000000000000000000000000000000000000001
         1000000000000000000000000000000000000000000000000000000001
         1000000000000000000000000000000000000000000000000000000001
1111111111000000000000000000000000000000000000000000000000000000001111111111
1000000000000000000000000000000000000000000000000000000000000000000000000001
1000000000000000000000000000000000000000000000000000000000000000000000000001
1000000000000000000000000000000000000000000000000000000000000000000000000001
1000000000000000000000000000000000000000000000000000000000000000000000000001
1111111111111111111111111111111111111111111111111111111111111111111111111111

