NO ./textures/ll.xpm
SO ./textures/ll.xpm
WE ./textures/ll.xpm
EA ./textures/ll.xpm





				F 20,255,3  
		C  					211, 		    88,12   






1111111111111111111111111
1000000000110000000000001
1011000001110000000000001
10010000000000000000000011111111
111111111011000001110000000000N01
10000000001100000111011111111111
11110111111111011100000010001
11110111111111011101010010001
11000000110101011100000010001
10000000000000001100000010001
10000000000000001101010010001
110000011101010111110111100111
11110111 1110101 101111010001
11111111 1111111 111111111111