NO ./textures/ll.xpm
SO ./textures/ll.xpm
EA ./textures/ll.xpm
WE ./textures/ll.xpm





		C  					211, 		    88,12   
				F 220,255,3



11111111
10111N01
10000001
111 1111
11111111
