NO textures/wet_sponge.xpm
SO textures/wet_sponge.xpm
WE textures/wet_sponge.xpm
EA textures/wet_sponge.xpm

C 153,204,255
F 0,0,0

111111111111111111111
101000001000000000001
101010101011111110001
100010100010000010001
111110101111101011101
100000101000101000001
101111101011101111111
101000001010100000101
101011111010111110101
101010001010100010101
101110101010101010101
100000101010001010001
111111101011111011101
100000101000100010001
100010101110101110111
100000100000100010101
1N0000001000000000001
100000000111111010101
100000000000000010001
101010111011111111101
111111111111111111111