NO textures/wet_sponge.xpm
SO textures/brick_walls/brickwall1.xpm
WE textures/brick_walls/brickwall2.xpm
EA textures/brick_walls/brickwall3.xpm

F 164,169,20
C 153,204,255

11111111
10000101
10010011
100000W1
11111111
