NO ./textures/ll.xpm
SO ./textures/ll.xpm
EA ./textures/ll.xpm
WE ./textures/ll.xpm





		C  					211, 		    88,12   
				F 220,255,3

11111
10 0N1  1
11111